11111111111111111111111111111
1P000000000000E000000000C0001
11111111111111111111111111111
