111111111111111
10000P000011111
1100000000C0011
100011110000011
1100C0000011111
100000001111111
111000000000001
1C0000000000111
111110000011111
111111100E00111
111111111111111
