1111111111111111
100000000000E001
1000000111111111
1P01111111111111
10000000000C0001
1111111111111111
